NO ./images/wall.xpm42
SO ./images/wall.xpm42
WE ./images/wall.xpm42
EA ./images/wall.xpm42
F 220,100,0
C 225,30,0

111111111111111
10000000N000001
100000000000001
100000000000001
100000000000001
111111111111111
