111111111111111
100000000000001
100100101000001
100000010000001
100000000000001
111111111111111
