NO ./images/test.xpm42
SO ./images/test.xpm42
WE ./images/test.xpm42
EA ./images/test.xpm42
F 220,100,0
C 225,30,0

11111
11101
10S01
10001
10001
11111