NO ./images/wall1.xpm42
SO ./images/wall2.xpm42
WE ./images/wall1.xpm42
EA ./images/wall2.xpm42

F 220,100,0
C 225,30,0
          111111111
11111     10000W011
100011111110000001
1000000000000000011
111111111111111111
