NO ./images/wall1.xpm42
SO ./images/wall2.xpm42
WE ./images/wall1.xpm42
EA ./images/wall2.xpm42

F 220,100,0
C 225,30,0
                     111111111
11111                10000W011
10001111111111111111110000001
100000000000000000000000000011
11111111111111111111111111111
