NO ./images/wall1.xpm42
SO ./images/wall2.xpm42
WE ./images/wall1.xpm42
EA ./images/wall2.xpm42

FT ./images/dirtycarpet2.xpm42
CT ./images/ceiling2.xpm42
          111111111
11111     100000011
100011111110000001
1000000000000000W11
111111111111111111
