NO ./images/wall1.xpm42
SO ./images/wall2.xpm42
WE ./images/wall1.xpm42
EA ./images/wall2.xpm42

FT ./images/dirtycarpet2.xpm42
CT ./images/ceiling2.xpm42

1111111111111111111111111
1000000000000000000000001
1011111111111111111111101
10111     100010011111001
1000111111100020011000011
1000000000000010W1101111
1111111111121111110011
      1100001 1000011
       111011 101111
         10111101
         10000001
         11111111